wwwwwwwwwwwwwwwwwwwwwwwwww
w------------------------w
w----c-------------------w
w------------------------w
w-----------w------------w
w-----------w------------w
w------wwwwwwwwwwww------w
w----------ew------------w
w-----------w------------w
w------------------------w
w-------------------A----w
w------------------------w
wwwwwwwwwwwwwwwwwwwwwwwwww