wwwwwwwwwwwwwwwwwwwwwwwwww
w-----------w-----w----A-w
w---w-------w-----w------w
w---w--------------------w
w---w-------w-----w------w
w---w-------w----ew------w
www-wwwwwwwwwwwwwwwww-wwww
w-----------w-------w----w
w----wwww-----------w----w
w----w------w-------w----w
w----w--wwwww-------w----w
w----w-------------------w
wwwwwwwwwwwwwwwwwwwwwwwwww