wwwwwwwwwwwwwwwwwwwwwwwwwww
w-A--x--x----xwx----x--x-ew
w-------------w-----------w
w-------------w-----------w
w-------------x-----------w
w-xx----------------------w
w-------------------------w
w------------------------xw
w------------------------xw
wwwwwwwwwwwwwwwwwwwwwwwwwww
