wwwwwwwwwwwwwwwwwwwwwwwwww
w-----------w-----w----e-w
w---w-------w-----w------w
w---w-------------w------w
w---w-------w-----w------w
w---w-------w-----w------w
www-wwwwwwwwwwwwwwwww-wwww
w-----------w-------w----w
w----wwww-----------w----w
w----w------w-------w----w
w----w--wwwww-------w----w
w----w------------------Aw
wwwwwwwwwwwwwwwwwwwwwwwwww