wwwwwwwwwwwwwwwwwwwwwwwwww
w-c---------x------------w
w-x--wwww--------wwww--x-w
w----w------w-------w----w
w----w---x--w----x--w----w
w-----------w------------w
w----wwwwwwwwwwwwwwww----w
w----------ew------------w
w----w------w-------w----w
w----w--x---w----x--w----w
w-A--wwww--------wwww----w
w--x--------x----------x-w
wwwwwwwwwwwwwwwwwwwwwwwwww